111111
100CC1
1P0CC1
100EE1
111111