	    F	1,	255,255
    SO		./textures/wood.xpm
C	0, 0, 0

		R    	600	600
  NO textures/purplestone.XPM
  WE  	  textures/redbrick.xpm
      EA textures/bluestone.xpm
	S	 textures/barrel.xpm

					
		11111111111111111
		11000000000001
		1200000000000111111
	111111000000000001
	100000000000111111
	1000000000001
	1000000000001
	1222222222221
	112222222221
	1022222222221
	1022222222221
	1S11111111111
	11